"a" = (/turf/wall,/area)
"b" = (/turf,/area)
"c" = (/turf/lowwall,/area)
"d" = (/turf/halfwall,/area)

(1,1,1) = {"
aaaaaaaaaaaaaaaaaaaaaaaaaaaaaaaaaaaaaaaaaaaaaaaaaa
abbbbbbbbbbbbbbcccccccccccccccccbbbbbbbbbbbbbbbbba
abbbbbbbbbbbbbbcccccccccccccccccbbbbbbbbbbbbbbbbba
abbbbabbbbbbbbbcccccccccccccccccbbababbbbbbbbbbbba
abbbbbbbbbbbbbbcccccccccccccccccbbbbbbbbbbbbbbbbba
abbbbbbbbbbbbbbcccccccccccccccccbbbbbbbbbbbabbbbba
abbbbbbcccccccccaaaaaaaacccaaccccccccccccbbbbbbbba
abbbbbbccccccccccccccccccccccccccccccccccbbbbbbbba
abbbbbbbbbbbbbbcccccccccccccccccabbacccccbbabbbbba
abbbbbbbbbbbbbbcccccccccccccccccabbacccccbbabbbbba
abbbbbbbbbbbabbcccccccccccccccccabbacccccbbabbbbba
abbbbabbbbbbbbbccccaaaaaaaaaacccabbacccccbbbbbbbba
abbbbbbbbbbbbbbcccccccccccccccccabbacccccbbbbbbbba
abbbbbbbbbabbbbcccccccccccccccccabbacccccbbbbbbbba
abbbbbbbbbbbbbbcccccccccccccccccabbacccccbbbbbbbba
abbbbbccccccccccccccccaaccccaccccccccccccbbbbbbbba
abbbbbccccccccccccccccaaccccaccccccccccccbbbbbbbba
abbbbbccccccccccccccccccccccacccaccccccccbbaaabbba
abbbbbccccccccccccccccccccccacccaccccccccbbbbbbbba
aabbaaaaaaacbbacccccccccccccacccabbbcccccbbbbbbbba
abbbbbbbbbbcbbacccccccaaccccccccabbbcccccbbbbbbbba
abbbbcccbbbcbbacccccccaaccccccccbbbbcccccbbbbbbbba
abbbbcdcbbbcbbacccccccccccccccccbbbbcccccbbbabbbba
abbaaddaaaacbbacccccccccccccccccbbbbcccccbbbabbbba
abbaadddaaacbbaccccaaaaaaaaaaaaaaaaacccccbbbbbbbba
abbbcddcccccbbacccccccccccccccccbbbbcccccbbbbbbbba
abbbccccccccbbaccccccccccccccccaaaaacccccbbbbbbbba
abbbbbbbccccbaacccccccccccccccccbbbbcccccbbbbbbbba
abcccccccddcbaddddddddccddddddddddddddddddddddbbba
abcddccccddcbadccccccccccccccccccccccccccccccdbbba
aaaddaaaaddaaadccccccccccccccccccccccccccccccdbbba
addddddddddddddcccccaccccccccccccccccccacccccdbbba
adccccccccccccccccccccccccaccccccccccccccccccdbbba
adcccccccccccccccccccccccccccccccccccccccccccdbbba
adcccccccccccccccccccccccccccccccccccccccccccdbbba
adccccaccccccccccccccccccccccccccccccccccccccdbbba
adcccccccccccccccccccccccccccccccccccccccccccdbbba
adccccccccccccdddddddddddddddccccccccccccccccdbbba
adccccccccccccdbbbbbbbbbbbbbdccccccccccccccccdbbba
adcccccccccccccbbbbbbbbbbbbbdccccccccccccccccdbbba
adcccccccccccccbbbbbbbbbbbbbdccccccccccccccccdbbba
adcccccaccccccdbbbbbbbbbbbbbdccccccccccccacccdbbba
adccccccccccccdbbbaaaaabbbbbdccacccccccccccccdbbba
adccccccccccccdbbbbbbbbbbbbbdccccccccccccccccdbbba
adcccccccccccccbbbbbbbbbbbbbdccccccccccccccccdbbba
adcccccccccccccbbbbbbabbbbbbdccddddddddddddccdbbba
adccccccccccccdbbbbbbbbbbbbbbbbbbbbbbbbbbbbbbbbbba
addddddddddddddbbbbbbbbbbbbbbbbbbbbbbbbbbbbbbbbbba
abbbbbbbbbbbbbbbbbbbbbbbbbbbbbbbbbbbbbbbbbbbbbbbba
aaaaaaaaaaaaaaaaaaaaaaaaaaaaaaaaaaaaaaaaaaaaaaaaaa
"}
