"a" = (/turf/wall,/area)
"b" = (/turf,/area)
"c" = (/turf/halfwall,/area)
"d" = (/turf/lowwall,/area)

(1,1,1) = {"
aaaaaaaaaaaaaaaaaaaaaaaaaaaaaaaaaaaaaaaaaaaaaaaaaa
abbbbbbbbbbbbbbbbbbbbbbbbbbbbbbbbbbbbbbbbbbbbbbbba
abbbbbbbbbbbbbbbbbbbbbbbbbbbbbbbbbbbbbbbbbbbbbbbba
abbbbbbbbbbbbbbbbbbbbbbbbbbbbbbbbbbbbbbbbbbbbbbbba
abbbbbbbbbbbbbbbbbbbbbbbbbbbbbbbbbbbbbbbbbbbbbbbba
abbbbbbbbbbbbbbbbbbbbbbbbbbbbbbbbbbbbbbbbbbbbbbbba
abbbbbbbbbbbbbbbbbbbbbbbbbbbbbbbbbbbbbbbbbbbbbbbba
abbbbbbbbbbbbbbbbbbbbbbbbbbbbbbbbbbbbbbbbbbbbbbbba
abbbbbbbbaaaaaaaaabbbbbbbbaaaaaaaaaaaaabbbbbbbbbba
abbbbbbbbabaccccccccccccccccccccccccccabbbbbbbbbba
abbbbbbbbabbccccccccccccccccccccccccccabbbbbbbbbba
abbbbbbbbbbaccababababadadddddddddddddabbbbbbbbbba
abbbbbbbbbbbccbbbbbbbbdddddddddddddbbbabbbbbbbbbba
abbbbbbbbbbaccabbbbbbbdddddddddddddbdbabbbbbbbbbba
abbbbbbbbbbbccbbbbbbbbdddbbbbbbaaddbdbbbbbbbbbbbba
abbbbbbbbbbaccabbbbbbbdddbbbbbbaaddbdbbbbbbbbbbbba
abbbbbbbbabbccbbbbbbbbdddbbbbbbbbddbdbabbbbbbbbbba
abbbbbbbbabbbbbbbbbbbbddddbbbbbbbddbdbabbbbbbbbbba
abbbbbbbbaaaaaaaaaaaaaddddaaabbbbddbdbabbbbbbbbbba
abbbbbbbbabbbbbbcabbbbddddbaabbbbddbdbabbbbbbbbbba
abbbbbbbbabbbbaacaabbbddddaaabbbbddbdbabbbbbbbbbba
abbbbbbbbabbaaccccabbaddddababbaaddbdbbbbbbbbbbbba
abbbbbbbbabbadccccdbbbaaddbbabbaaddbdbbbbbbbbbbbba
abbbbbbbbabbbdccccbbbbbcccbbabbbbddbdbbbbbbbbbbbba
abbbbbbbbabbbdccccbbbbacccbbabbbbddbdbbbbbbbbbbbba
abbbbbbbbabaaacccaaabbdcccbbabbbbddbdbbbbbbbbbbbba
abbbbbbbbbbabdcccdbaabdcccababbbbddbdbbbbbbbbbbbba
abbbbbbbbbbabdddddbbbbdcccababbbbddbdbbbbbbbbbbbba
abbbbbbbbbbabbbabbabbaacccababbbbddbdbbbbbbbbbbbba
abbbbbbbbbbabbbaaabbbbdddabbabbbbddbdbbbbbbbbbbbba
abbbbbbbbbbadbbbbaabbbbbbabbabbbaddbdbbbbbbbbbbbba
abbbbbbbbbbcdbbbbbaabbbbabbbabbbaddbdbbbbbbbbbbbba
abbbbbbbbbbcdbbbbbbaabbaaddddddddddbdbabbbbbbbbbba
abbbbbbbbbbadbbbbbbbaababddddddddddbdbabbbbbbbbbba
abbbbbbbbbbabbbaaabbbbbbbbbbabbbbbbbdbabbbbbbbbbba
abbbbbbbbababbbbbaabbabbbbbbabdddddddbabbbbbbbbbba
abbbbbbbbabbbbbbaaaaaaaaaaaaabbbbbbbbbabbbbbbbbbba
abbbbbbbbaaaaaaaaaaaaaaaaaaaaaaaaaaaaaabbbbbbbbbba
abbbbbbbbbbbbbbbbbbbbbbbbbbbbbbbbbbbbbbbbbbbbbbbba
abbbbbbbbbbbbbbbbbbbbbbbbbbbbbbbbbbbbbbbbbbbbbbbba
abbbbbbbbbbbbbbbbbbbbbbbbbbbbbbbbbbbbbbbbbbbbbbbba
abbbbbbbbbbbbbbbbbbbbbbbbbbbbbbbbbbbbbbbbbbbbbbbba
abbbbbbbbbbbbbbbbbbbbbbbbbbbbbbbbbbbbbbbbbbbbbbbba
abbbbbbbbbbbbbbbbbbbbbbbbbbbbbbbbbbbbbbbbbbbbbbbba
abbbbbbbbbbbbbbbbbbbbbbbbbbbbbbbbbbbbbbbbbbbbbbbba
abbbbbbbbbbbbbbbbbbbbbbbbbbbbbbbbbbbbbbbbbbbbbbbba
abbbbbbbbbbbbbbbbbbbbbbbbbbbbbbbbbbbbbbbbbbbbbbbba
abbbbbbbbbbbbbbbbbbbbbbbbbbbbbbbbbbbbbbbbbbbbbbbba
abbbbbbbbbbbbbbbbbbbbbbbbbbbbbbbbbbbbbbbbbbbbbbbba
aaaaaaaaaaaaaaaaaaaaaaaaaaaaaaaaaaaaaaaaaaaaaaaaaa
"}
